###############
#____________M#
#_____________#
#__#____#_____#
#__#____#_____#
#__#____#_____#
#__#____#_____#
#__#___###____#
#__#____#_____#
#___#####_____#
#________#____#
#__#__________#
#_____________#
#______P______#
###############