###############
##______#____M#
#__#__#___###_#
#__##__#___#__#
#__#___###__#_#
#_###___#__#__#
##_#____#____##
##_#___###__#_#
#___#___###___#
#_#_##_##_#__##
#___#__#______#
###___#__#_##_#
#_#_##___#___##
#___#__P___#__#
###############